12 20
@@@@@@@@@@@@@@@@@@@@
@..................@
@..........@@@@@@@.@
@..................@
@..........@@@@@@@.@
@..........@@@@@@@.@
@..................@
@..........@@@@@@@.@
@..........@@@.....@
@..........@@@@@@@.@
@..........@@@@@@@.@
@@@@@@@@@@@@@@@@@@@@