11111111111111111111
10000000000000000001
10000000000111111101
10000000000000000001
10000000000111111101
10000000000111111101
10000000000000000001
10000000000111111101
10000000000111000001
10000000000111111101
10000000000111111101
11111111111111111111
