6 46
..@@...@@....@@....@@....@@....@@....@@....@@.
.@..@@@..@@@@..@@@@..@@@@..@@@@..@@@@..@@@@..@
@............................................@
@............................................@
.@..@@@..@@@@..@@@@..@@@@..@@@@..@@@@..@@@@..@
..@@...@@....@@....@@....@@....@@....@@....@@.



















